NO ./imgs/wall.xpm
SO ./imgs/floor.xpm
WE ./imgs/soil.xpm
EA ./imgs/ston.xpm

F 128,0,0
C 225,30,0

111111111111
10000D0W0001
111111111111