NO ./path_to_the_north_texture
SO ./path_to_the_south_texture
WE ./path_to_the_west_texture
EA ./path_to_the_east_texture

F 220,100,0
C 225,30,0

1111111111111111111111111
1000000000110000000000001
1011000001110000010000001
1001000000000000000000001
1111111110110000011100001
10000000001100000111011111111
11110111111111011100001010001
11110111111111011101011010001
1100000011010101110000000011111
1000000000000000000000010010001
1000000000000000110101001000111
11000001110101011111011110N01
11110111 1110101 101111010001
11111111 1111111 111111111111