NO ./imgs/textures/chiseled_stone_bricks.xpm
SO ./imgs/textures/cobblestone.xpm
WE ./imgs/textures/mossy_stone_bricks.xpm
EA ./imgs/textures/stone_bricks.xpm

F 91,41,31
C 167,231,255

1111111111111111111111111
1000000000110000000000001
1011000001110000010000001
1001000000000000000000001
1111111110110000011100001
10000000001100000111011111111
11110111111111011100001010001
11110111110D01011101011010001
110000001101011110000000011111
1000000000000000000000010010001
1000000000000000110101001D11111
11000001110101011111011110N01
11110111 1110101 101111010001
11111111 1111111 111111111111