NO ./imgs/wall.xpm
SO ./imgs/floor.xpm
WE ./imgs/soil.xpm
EA ./imgs/ston.xpm

F 0,0,255
C 0,255,0

1111111111111111111111111
1000000000110000000000001
1011000001110000010000001
1001000000000000000000001
1111111110110000011100001
10000000001100000111011111111
11110111111111011100001010001
11110111110001011101011010001
1100000011010101110000000011111
1000000000000000000000010010001
1000000000000000110101001D11111
11000001110101011111011110N01
11110111 1110101 101111010001
11111111 1111111 111111111111