NO ./imgs/wall.xpm
SO ./imgs/floor.xpm
WE ./imgs/soil.xpm
EA ./imgs/ston.xpm

F 128,0,0
C 225,30,0

111111111111
100000000001
100000000001
100000000001
100000000001
100W00000001
100000000001
111111111111